|||||||||||||||||||||||||||||
|  1      ......       P    |
|X||||||||||||||||||||||    |
|X|                         |
| |||||||||||||||||||||     |
|B    B          B          |
| ||||||||||||||||||||||    |
|                           |
| ||||||||| ||||||||||||    |
|                          ||
| ||||||||| |||||||||||||| ||
|                          ||
|||||||||||||||||||||||||||||